NO graphic/textures/blue_brick.xpm
EA graphic/textures/stone_wall.xpm
SO graphic/textures/red_brick.xpm
WE graphic/textures/wood_wall.xpm

C 35,19,73
F 15,6,40

111111111111111
111111000111111
111110000011111
1111000N0001111
111000000000111
110000000000011
000001111100000
110000111000011
111000010000111
111100000001111
111110000011110
111111000111111
111111111111111
