   WE                            graphic/textures/wolf1.xpm
         NO      graphic/textures/wolf2.xpm   



SO graphic/textures/hitler.xpm

F      17,    38,     64

EA graphic/textures/wolf3.xpm



                       C               218, 134, 075

1111111111111111111111111
1N00110000100000000000001
0000110000000000111111001
1000110000000000110001001
1000000000100000000001001
1111111111111111111111111
