NO textures/wolf1.xpm
WE textures/wolf3.xpm
EA textures/wolf4.xpm

F 11,169,20
C 153,204,255

11111111111111111111111111111111111
10000011111111100000111111111000001
10000011111111100000111111111000001
10000011111111100000111111111000001
10000011111111100000111111111000001
1N000000000000000000000000000000001
11111111111111111111111111111111111