NO graphic/textures/blue_brick.xpm
EA graphic/textures/wood_wall.xpm
SO graphic/textures/red_brick.xpm
WE graphic/textures/stone_wall.xpm

F 255,10,210
C 201,255,90

11111111111
  1100011
11110000111
11110000111
10000000001
110000W0001
10000000001
10001000001111111
10000000001
10000000001111111
10000000001
10000000001
10000000001
10000000001111111111111111111111111111
10000000000000000000000000000000000001
10000000000000000000000000000000000001
10000000000000000000000000000000000001
10000000000000000000000000000000000001
10000000000000000000000000000000000001
10000000000000000000000000000000000001
10000000000000000000000000000000000001
10000000000000000000000000000000000001
10000000000000000000000000000000000001
10000000000000000000000000000000000001
10000000000000000000000000000000000001
10000000000000000000000000000000000001
10000000000000000000000000000000000001
10000000001111111111111111111111111111
10000000001
10000000001
10000000001
10000000001
10000000001
10000000001
10000000001
10000000001
11110001111
11110001111
11110001111
11111111111
